europese komisija	Evropska komisija mora narediti analizo vzrokov rasti cen hrane, menita kmetijski minister Jarc in njegov francoski kolega.
europeska komisija	Evropska komisija mora narediti analizo vzrokov rasti cen hrane, menita kmetijski minister Jarc in njegov francoski kolega.
evrosta komisija	Evropska komisija mora narediti analizo vzrokov rasti cen hrane, menita kmetijski minister Jarc in njegov francoski kolega.
evroren komisija reagira na rast co-meal	Bo evropska komisija analizirala vzroke rasti cen hrane.
bo komisija analizировала vzroke 'rozko'?	Bo evropska komisija analizirala vzroke rasti cen hrane.
evro nacionalisten onderzoekieron	Bo evropska komisija analizirala vzroke rasti cen hrane.
evroscopoa / europa komisija	Evropska komisija bi morala narediti analizo vzrokov in posledic rasti cen hrane po posameznih sektorjih, sta po današnjem srečanju v Ljubljani povedala minister za kmetijstvo Iztok Jarc in njegov francoski kolega Michel Barnier.
nih komisija	Evropska komisija bi morala narediti analizo vzrokov in posledic rasti cen hrane po posameznih sektorjih, sta po današnjem srečanju v Ljubljani povedala minister za kmetijstvo Iztok Jarc in njegov francoski kolega Michel Barnier.
ue komisija	Evropska komisija bi morala narediti analizo vzrokov in posledic rasti cen hrane po posameznih sektorjih, sta po današnjem srečanju v Ljubljani povedala minister za kmetijstvo Iztok Jarc in njegov francoski kolega Michel Barnier.
verschil in talen legaal frankrijk	Sicer imata po njunih besedah Slovenija in Francija podobna stališča glede skupne kmetijske politike in podobne pomisleke glede reforme vina.
verenigde staten van frankreich	Sicer imata po njunih besedah Slovenija in Francija podobna stališča glede skupne kmetijske politike in podobne pomisleke glede reforme vina.
welke politieke houding hebben soeslovenia en frankrijk nodig	Sicer imata po njunih besedah Slovenija in Francija podobna stališča glede skupne kmetijske politike in podobne pomisleke glede reforme vina.
будет ли EU принимать вступительный лист?	Poudarila sta pomen dobrega sodelovanja med državama tudi na področju kmetijstva v času predsedovanja EU prihodnje leto.
значение доброго са伙 в EU	Poudarila sta pomen dobrega sodelovanja med državama tudi na področju kmetijstva v času predsedovanja EU prihodnje leto.
что такое добрая связь	Poudarila sta pomen dobrega sodelovanja med državama tudi na področju kmetijstva v času predsedovanja EU prihodnje leto.
кто omenil reforma земельной кладки	Med možnimi ukrepi EU je Barnier omenil obnovo zemlje v prahi.
eun barnier omenil  земле?	Med možnimi ukrepi EU je Barnier omenil obnovo zemlje v prahi.
narobe paжина, omeni	Med možnimi ukrepi EU je Barnier omenil obnovo zemlje v prahi.
чему помогает nova riviera asylvani	Gre za štiri milijone hektarjev zemlje, obnova bi omogočila večjo proizvodnjo in s tem znižanje cen.
quantos гектаров  землy beर्च	Gre za štiri milijone hektarjev zemlje, obnova bi omogočila večjo proizvodnjo in s tem znižanje cen.
сколько tierra будет взять, чтобы повысить рину	Gre za štiri milijone hektarjev zemlje, obnova bi omogočila večjo proizvodnjo in s tem znižanje cen.
quando o governo  европы  decida atomar procedimento	O tem bo Evropska komisija odločala septembra.
quando a komisija  европska entscheider o que	O tem bo Evropska komisija odločala septembra.
quando o que o european commission  decisa	O tem bo Evropska komisija odločala septembra.
может mlemak ukrep	Možen ukrep so tudi dodatne kvote na področju mleka, je dejal.
может ukrep mlec ukrep	Možen ukrep so tudi dodatne kvote na področju mleka, je dejal.
может ukrep ukrep mlek	Možen ukrep so tudi dodatne kvote na področju mleka, je dejal.
zakaj cene еды naraščajo - это	Zakaj cene hrane naraščajo
какие cene uchten	Zakaj cene hrane naraščajo
zabagai cene  храни	Zakaj cene hrane naraščajo
может EU isseurr umigerить цены еды?	Strinjala sva se, da bi morala Evropska komisija narediti analizo vzrokov po posameznih sektorjih in analizo posledic takšnega dogajanja, je Barnier odgovoril na vprašanje, kaj lahko EU naredi za umiritev cen hrane.
europäische komisija unergie	Strinjala sva se, da bi morala Evropska komisija narediti analizo vzrokov po posameznih sektorjih in analizo posledic takšnega dogajanja, je Barnier odgovoril na vprašanje, kaj lahko EU naredi za umiritev cen hrane.
¿Cómo doe europäische komisija оценку  cen makanan?	Strinjala sva se, da bi morala Evropska komisija narediti analizo vzrokov po posameznih sektorjih in analizo posledic takšnega dogajanja, je Barnier odgovoril na vprašanje, kaj lahko EU naredi za umiritev cen hrane.
что означает pridelovalce mesa?	Izpostavil je visoke stroške za pridelovalce mesa oz. perutnine in dejal, da bi bilo treba uravnotežiti posledice.
значение pridelovalci mesa	Izpostavil je visoke stroške za pridelovalce mesa oz. perutnine in dejal, da bi bilo treba uravnotežiti posledice.
je mesa постояннas	Izpostavil je visoke stroške za pridelovalce mesa oz. perutnine in dejal, da bi bilo treba uravnotežiti posledice.
redenen za triatlonom	Po Barnierjevem mnenju gre za trajnejše poviševanje cen in je treba najti ustrezne odgovore.
hoe werkt barnierjev  onderzoek?	Po Barnierjevem mnenju gre za trajnejše poviševanje cen in je treba najti ustrezne odgovore.
po barnierjevem мнению gre za	Po Barnierjevem mnenju gre za trajnejše poviševanje cen in je treba najti ustrezne odgovore.
кто такой Iztok Jarc	Kmetijski minister Iztok Jarc meni, da je treba odpreti razpravo o visokih cenah hrane tudi na evropski ravni.
кто is iktok jarc	Kmetijski minister Iztok Jarc meni, da je treba odpreti razpravo o visokih cenah hrane tudi na evropski ravni.
nih. minister jert	Kmetijski minister Iztok Jarc meni, da je treba odpreti razpravo o visokih cenah hrane tudi na evropski ravni.
 евроманские cene	Tudi Jarc meni, da treba odpreti razpravo o visokih cenah hrane tudi na evropski ravni.
сколько кредитов я получил в euro	Tudi Jarc meni, da treba odpreti razpravo o visokih cenah hrane tudi na evropski ravni.
почему jarc meni свои цены очень высокие	Tudi Jarc meni, da treba odpreti razpravo o visokih cenah hrane tudi na evropski ravni.
ожидается ли rast cen?	Sicer je, kot pravi, težko napovedati, ali se bodo napovedi o rasti cen v prihodnje uresničile, bo pa ministrstvo v vsakem primeru pozorno spremljalo dogajanje in poskušalo ustrezno reagirati.
можно napovedati цены?	Sicer je, kot pravi, težko napovedati, ali se bodo napovedi o rasti cen v prihodnje uresničile, bo pa ministrstvo v vsakem primeru pozorno spremljalo dogajanje in poskušalo ustrezno reagirati.
может наvestnik uresničить деньги?	Sicer je, kot pravi, težko napovedati, ali se bodo napovedi o rasti cen v prihodnje uresničile, bo pa ministrstvo v vsakem primeru pozorno spremljalo dogajanje in poskušalo ustrezno reagirati.
welke talen verwijzen naar frankrijk	Podobne usmeritve Slovenije in Francije
wat is de naam voor slovenia in frankrijk?	Podobne usmeritve Slovenije in Francije
riviera, die bekend staat als provincie, zijn verwijzing naar:	Podobne usmeritve Slovenije in Francije
komt frankrijk v. smolderijs synoniem s. francis	Jarc je dejal, da imata Francija in Slovenija precej podobna stališča na skupno kmetijsko politiko.
wie is jac jaric?	Jarc je dejal, da imata Francija in Slovenija precej podobna stališča na skupno kmetijsko politiko.
eeft Jarc dejal, dass Польza vs. Francia	Jarc je dejal, da imata Francija in Slovenija precej podobna stališča na skupno kmetijsko politiko.
Faktorи, по которым Deutschland potreba sterkerе ратовать proti anderen	Za Slovenijo je stabilnost v tem sektorju zelo pomembna in osebno mislim, da ravno skupna kmetijska politika daje kmetijstvu tisto potrebno dolgoročno stabilnost in možnost, da dobro konkurira, je povedal Jarc.
чему verjagine poslovenia	Za Slovenijo je stabilnost v tem sektorju zelo pomembna in osebno mislim, da ravno skupna kmetijska politika daje kmetijstvu tisto potrebno dolgoročno stabilnost in možnost, da dobro konkurira, je povedal Jarc.
为什么 smog je важен	Za Slovenijo je stabilnost v tem sektorju zelo pomembna in osebno mislim, da ravno skupna kmetijska politika daje kmetijstvu tisto potrebno dolgoročno stabilnost in možnost, da dobro konkurira, je povedal Jarc.
o que sẽ ocorrer जब brnier rekomendações do barnierjev мнений?	Po Barnierjevem mnenju je treba najti ustrezne odgovore za povišanje cen hrane.
_______ - nih. mнение, po barnierjeveм мнению, debe je najti ustrežene ответы за повышение cen alimentaire	Po Barnierjevem mnenju je treba najti ustrezne odgovore za povišanje cen hrane.
bodem barnierjev мнений	Po Barnierjevem mnenju je treba najti ustrezne odgovore za povišanje cen hrane.